0  0 0 4 7
1  0 1 0 1
2  0 2 0 2
3  0 3 0 3
4  0 4 0 4
5  0 5 0 5
6  0 6 0 6
7  0 7 0 7
8  0 8 0 8
9  0 9 0 9
10 1 9 1 9
11 2 9 2 9
12 2 8 2 8
13 2 7 2 7
14 2 6 2 6
15 2 5 2 5
16 2 4 2 4
17 2 3 2 3
18 2 2 2 2
19 3 2 3 2
20 4 2 4 2
21 4 3 4 3
22 4 4 4 4
23 4 5 4 5
24 4 6 4 6
25 4 7 7 9
26 5 7 6 9
27 6 7 5 9
28 6 6 4 9
